00000000
01001010
00101003
01001010
00101010
01000010
01111100
00020000