,IIIIIIIIIIIIIIIIIIIIII,,,,,,,,,
,IFFFFFFFFFFFFFFFFFFFFI,,,,,,,,,
,IFFFFFFFFFFFFFFFFFFFFI,,,,,,,,,
,I#############FFFFFFFI,,,,,,,,,
,I............#FFFFFFFI,,,,,,,,,
,I............#FFFFFFFI,,,,,,,,,
,I.....nse....#FFFFFFFI,,,,,,,,,
I/............#FFFFFFFI,,,,,,,,,
X3............#FFFFFFFI,,,,,,,,,
X3.w..........#FFFFFFFI,,,,,,,,,
X3............IFFFFFFFI,,,,,,,,,
X3............#FFFFFFFI,,,,,,,,,
I\............IFFFFFFFI,,,,,,,,,
,IIIIIIIIIIIIIIIIIIIIII,,,,,,,,,
,,,,,,,,,,,,,,,,,,,,,,,,,,,,,,,,
,,,,,,,,,,,,,,,,,,,,,,,,,,,,,,,,
,,,,,,,,,,,,,,,,,,,,,,,,,,,,,,,,
,,,,,,,,,,,,,,,,,,,,,,,,,,,,,,,,
,,,,,,,,,,,,,,,,,,,,,,,,,,,,,,,,
,,,,,,,,,,,,,,,,,,,,,,,,,,,,,,,,
,,,,,,,,,,,,,,,,,,,,,,,,,,,,,,,,
,,,,,,,,,,,,,,,,,,,,,,,,,,,,,,,,
,,,,,,,,,,,,,,,,,,,,,,,,,,,,,,,,
,,,,,,,,,,,,,,,,,,,,,,,,,,,,,,,,
,,,,,,,,,,,,,,,,,,,,,,,,,,,,,,,,
,,,,,,,,,,,,,,,,,,,,,,,,,,,,,,,,
,,,,,,,,,,,,,,,,,,,,,,,,,,,,,,,,
,,,,,,,,,,,,,,,,,,,,,,,,,,,,,,,,
,,,,,,,,,,,,,,,,,,,,,,,,,,,,,,,,
,,,,,,,,,,,,,,,,,,,,,,,,,,,,,,,,
,,,,,,,,,,,,,,,,,,,,,,,,,,,,,,,,
,,,,,,,,,,,,,,,,,,,,,,,,,,,,,,,,
