00011111
01001010
00101003
01111010
01101010
01000010
00111100
00000000