00000000
01110000
01000110
00101010
01001000
10010010
01111100
00000003