IIIIIIIIIIIIIIIIIIIIIIIIIIIIIIIIIIIIIIII
IUUUUUUUUUUUUUUUUIUUUUUUUUUUUUUUUUUUUUUI
IUUUUUUUUUWWUUUUUIUUUUUUUUUUUUUUUUUUUUUI
IUUUUUUUUUWWUUUUUIUUUUUUUUUUUUUUWUUUWUUI
IUUUUUUUUUUUUUUU/I\UUUUUUUUUUUUUUUUUUUUI
IUUUUUUUUUUUUUUUTTTUUUUUUUUUUUUUUUUUWUUI
IUUUUUUUUUUUUUUUUSUUUUUUUUUUUUUUUUUUUUUI
IUUUUUUUUUUUUUUUTTTUUUUUUUUUUUUUUUUUUUUI
IUUUUUUUUUUUUUUU\I/UUUUUUUWWUUUUUUUUUUUI
IUUUUUUUUUUUUUUUUIUIIIIIIIWWUUUUUUUUUUUI
IUUUIIIIIIIIIIIIIIUUUUUUUUUUUUUUUUUUUUUI
IUUUWWUUUUUUUUUUUIUUUUUUUUUUUUUUUUUUUUUI
IUUUWWUUUUUUUUUU/IIIIIIIII\UUUUUUUUUUUUI
IUUUUUUUUUUUUUU/Z/UUUUUUU\Z\UUUUUUUUUUUI
IUUUUUUUUUUUUU/Z/UUUUUUUUU\Z\UUUUUUUUUUI
IUUUUUUUUUUUU/Z/UUUUUUUUUUU\Z\UUUUUUUUUI
IUUUU/TUT\UU/Z/UUUUUUUUUUUUU\Z\UU/TUT\UI
IIIIITTSTIIIIIUUUUUUUKUUUUUUUUUIIITSTIII
IUUUU\TUT/UU\Z\UUUUUUUUUUUUUU/IUU\TUT/UI
IUUUUUUUUUUUU\Z\UUUUUUUUUUUUIZIUUUUUUUUI
IUWWUUUUUUUUUU\Z\UUUUUUUUUUUUI/UUUUUUUUI
IUWWUUUUUUUUUUU\Z\UUUUUUU/ITSTUUUUUUUUUI
IUUUUUUUUUUUUUUU\IIIIIIIII/UUUUUUUUUUUUI
IUUUUUUUUUUUUUUUUUUUUUUUUIUUUUUUUUUUUUUI
IUUUUUUUUUUUUUUUUUUUUUUUUIUUUUUUUUUUUUUI
IUUUUUUUUUUUUUUUUUUUUUUUUIUUUUUWWUUUUUUI
IUUUUUUUUUUUUUUUUUUUUUUUUIIIIIIWWUUUUUUI
IIIIIIIIIIIIIIWWWIUUUUUUUIUUUUUUUUUUUUUI
IUUUUUUUUUUUUUWWWUUUUUUUUIUUUUUUUUUUUUUI
IUAAAAAUUUUUUUUUUUUUUUUUUIUUUUUUUUUUUUUI
IUAF-_UUUUUUUUUUUUUUUUUUUIUUUUUUUUUUUUUI
IUAFFFAUUUUUUUUUUUUUUUUUUIUUUUWWIIIIIIII
IIIFIIIIIIIIIIUUUUUUUUUUUIUUUUWWUUUUUUUI
111~111111111IIIIIIIIIIIIIUUUUUUUUUUUUUI
1GGGGGGGGGGGG1UUUUUUUUUUUIUUUUUUUWUWUUUI
1GGGGGGGGGGGG1UUUUUUUUUUUTUUUUUUUUUUUUUI
1GGG4GGGGGGGG1UUUUUUUUUUU#EUUUUUUWUWUUUI
1GGGGGGGGGGGG1UUUUUUUUUUUTUUUUUUUUUUUUUI
1GGGGGGGGGGGG1UUUUUUUUUUUIUUUUUUUUUUUUUI
1XXXX111111111IIIIIIIIIIIIIIIIIIIIIIIIII
