00000000
11111110
01001110
01000010
01111010
00000010
01111110
00000003