,IIIIIIIIIIIIIIIIIIIIIIIIIIIIII,
,IFFFFFFFFFFFFFFFFFFFFFFFFFFFFI,
,IFFFFFFFFFFFFFFFFFFFFFFFFFFFFI,
,IFFFFFFFFFFFFFFFFFFFFFFFFFFFFI,
,IPPPPPIIIIIIIFFFFIIIIIIIIPPPPI,
,I.....I....\IPPPPI/....I.....I,
,I.....I................I.....I,
,I.....I................I.....I,
,I.....I................I.....I,
,I.....IMMMMMMMMMMMMMMMMI.....I,
,I.....ISSSSSSSSSSSSSSSSI.....\,
,I.....IIIISSSITIISSIIIII.....1B
,I.....ISS#SSS#SSISS#SSSI...e.1B
,/PPPPPISS#SSS#SSISS#SSSIIIIIIII
B3FFFFFISSISSSISSISSISSSI,,,,,,,
B3FFwFFISS#SSS#SSISS#SSSI,,,,,,,
B3FFsFFISS#SSS#SSISS#SSSI,,,,,,,
,\FFFFFISSISSSILEISSISSSI,,,,,,,
,IIIIIIISS#SSSSSSISS#SSII,,,,,,,
,,,,,,,ISS#SSSSSSISS#SSII,,,,,,,
,,,,,,,IIIIIIIIIIIIIIIIII,,,,,,,
,,,,,,,,,,,,,,,,,,,,,,,,,,,,,,,,
,,,,,,,,,,,,,,,,,,,,,,,,,,,,,,,,
,,,,,,,,,,,,,,,,,,,,,,,,,,,,,,,,
,,,,,,,,,,,,,,,,,,,,,,,,,,,,,,,,
,,,,,,,,,,,,,,,,,,,,,,,,,,,,,,,,
,,,,,,,,,,,,,,,,,,,,,,,,,,,,,,,,
,,,,,,,,,,,,,,,,,,,,,,,,,,,,,,,,
,,,,,,,,,,,,,,,,,,,,,,,,,,,,,,,,
,,,,,,,,,,,,,,,,,,,,,,,,,,,,,,,,
,,,,,,,,,,,,,,,,,,,,,,,,,,,,,,,,
,,,,,,,,,,,,,,,,,,,,,,,,,,,,,,,,
