00000000
01011010
00101100
01000000
00111110
00000010
00111100
00000003