01000000
01000010
01101010
01000010
01101010
01000010
01101110
00001003