00011111
01001010
00101003
11101010
00001010
01000011
00111100
00000000