I{{{{{{{{{{{{{{{{{{{{{{{{{{{{{{{{{{{{{{{{{{{{{{{{{{{{{{{{{{{{{{{
I..............................................................I
I......IIIIIIIIIIIIIIIIII......................................I
II.....I/............4.I................I......................I
II.....I...............I.........IIIIIIII......................I
II.....I.../IIIIIIIIIIII.IIIIII..I.............................I
I......I...I...I/.\......IFFFFI................................I
I......I...I....I..\.....IFFFFI......V.........................I
IIIIIIII...I....I...I....IFFFFI................................I
I.....IIIIIIIIIIIIIIIIIIIIFFFFIIIIIIIIIIIIIIIII................I
I.....I........I........\IFFFFI/....III.......I................I
I.....I........I...IIIIIIIIIIIIIIIIIII........I................I
I.....I........I...IF................I........I................I
I.....I........I...IF................I........I.....IXXXI......I
I.....I........I...IBBBBBBBBBBBBB..BII........III...IFFFI.._...I
I.....I........I...I................II........I\I...IFFFI......I
I.....I........I...I..C.............II........I.XX..IFFFI......I
I.....I........I...ITTTTTT..........II........I.XX..IFFFI......I
I.....IIIIIIIII/...ITTTTTT..........\IIIIIIIIII/F\II/FFF\IIIII/.
I.....FFFFFFFFF....I...C.............FFFFFFFFFF1FFFFFFFFFFFFFFFF
I.....FFFFFFFFF....IM................FFFFFFFFFF1FFFFFFFFFFFFFFFF
I.....FFFFFFFFF....ITTTTTTTT.........FFFFFFFeFF1FFFFFFFFFFFFFFFF
I.....FFFFFFFFF....ITTTTTTTTC........FFFFFFFFFF1FFFFFFFFFFFFFFFF
I.....IIIIIIIII\...I................/IIIIIIIIII\F/II\FFF/IIIII\.
II....I........I...ITTTTTTTTTTTTTTTTII........II....IFFFI......I
II....I........IIIIIIIIIIIIIIIIIIIIIII........II....IFFFI......I
II....I........I....................II........II....IFFFI......I
II....I........I....................II........II...LIFFFI......I
II....I........I....................II........II....IXXXI......I
II\...I........I....................II........II...............I
IIIIIIIIIIIIIIIIIIIIIIIII\..../IIIIIIIIIIIIIIIIIIIIIIIIIIIIIIIII
I........................IXXXXI.........XXXXXXXXX..............I
I....=...................IFFFFI..........................#.....I
IIIIIIIIIIIIIIIIIIIIIIIIIIFFFFI....E..{}..................R.T..I
I.................FFFFFFFFFFFFI................................I
I.................FFFFFFFFFFFFI.........................C......I
I.................FFFFFFFFFFFFI................................I
IIIIIIIIIIIIIIIIIIIIIIIIIIIIIIIIIIIIIIIIIIIIIIIIIIIIIIIIIIIIIIII
IIIIIIIIIIIIIIIIIIIIIIIIIIIIIIIIIIIIIIIIIIIIIIIIIIIIIIIIIIIIIIII
I..............................................................I
I..............................................................I
I..............................................................I
I..............................................................I
I..............................................................I
I..............................................................I
I..............................................................I
I..............................................................I
I..............................................................I
I..............................................................I
I..............................................................I
I..............................................................I
I..............................................................I
I..............................................................I
I..............................................................I
I..............................................................I
I..............................................................I
I..............................................................I
I..............................................................I
II.............................................I...............I
II.............................................I...............I
II.............................................I...............I
II.............................................I...............I
II.............................................I...............I
I..............................................................I
