IIIIIIIIIIIIIIIIIIIIIIIIIIIIIIIIIIIIIIIIIIIIIIIIIIIIIIIIIIIIIIII
..FFFFIFFFFFFFFFFFFFFFFFFFFFFFFFFFFFFFFFFFFFFFFFFFFFFFFFFFFFFI..
..FFFFIFFFFFFFFFFFFFFFFFFFFFFFFFFFFFFFFFFFFFFFFFFFFFFFFFFFFFFI..
..FFFFIFFFFFFFFFFFFFFFFFFFFFFFFFFFFFFFFFFFFFFFFFFFFFFFFFFFFFFI..
IIIIIIIPPPPPPPPIIIIIIIIIIIFFFFIIIIIIIIIIIIIIIIIIIIIIIIIIIPPPPI.I
I.....I........I...I....\IPPPPI/....III.......I.........I....I.I
I.....I........I...I................II........I.........I....I.I
I.....I........I...I................II........I.........I....I.I
I.....I........I...I................II........I.....IXXXI....I.I
I.....I........I...IMMMMMMMMMMMMMMMMII........III...IFFFI....I.I
I.....I........I...ISSSSSSSSSSSSSSSSII........I\I...IFFFI.....\I
I.....I........I...IIIISSSITIISSIIIIII........I.XX..IFFFI.....1B
I.....I........I...ISS#SSS#SSISS#SSSII........I.XX..IFFFI...e.1B
I..../PPPPPPPPPI...ISS#SSS#SSISS#SSSIIIIIIIIIII/F\II/FFF\IIIIIII
I...B3FFFFFFFFFI...ISSISSSISSISSISSSIFFFFFFFFFFFFFFFFFFFFFFFFFFF
I...B3FFwFFFFFFI...ISS#SSS#SSISS#SSSIFFFFFFFFFFFFFFFFFFFFFFFFFFF
I...B3FFsFFFFFFI...ISS#SSS#SSISS#SSSIFFFFFFFFFFFFFFFFFFFFFFFFFFF
I....\FFFFFFFFFI...ISSISSSILEISSISSSIFFFFFFFFFFFFFFFFFFFFFFFFFFF
I.....IIIIIIIIII...ISS#SSSSSSISS#SSIII.IIIIIIII\F/II\FFF/IIIII\.
II....I........I...ISS#SSSSSSISS#SSIII........II....IFFFI......I
II....I........IIIIIIIIIIIIIIIIIIIIIII........II....IFFFI......I
II....I........I....................II........II....IFFFI......I
II....I........I....................II........II...LIFFFI......I
II....I.._.....I................T...II........II....IXXXI......I
II\...I........I....................II........II...............I
IIIIIIIIIIIIIIIIIIIIIIIII\..../IIIIIIIIIIIIIIIIIIIIIIIIIIIIIIIII
I........................IXXXXI.........XXXXXXXXX..............I
I....=...................IFFFFI..........................#.....I
IIIIIIIIIIIIIIIIIIIIIIIIIIIIIIIIIIIIIIIIIIIIIIIIIIIIIIIIIIIIIIII
IIIIIIIIIIIIIIIIIIIIIIIIIIIIIIIIIIIIIIIIIIIIIIIIIIIIIIIIIIIIIIII
I..............................................................I
I..............................................................I
I..............................................................I
I..........MBF.........................................R.......I
I..............................................................I
I..............................................................I
I...................C..........................................I
I..............................................................I
I................E.{}..........................................I
I..............................................................I
I..............................................................I
I..............................................................I
I..............................................................I
I..............................................................I
I..............................................................I
I..............................................................I
I..............................................................I
I..............................................................I
I..............................................................I
II.............................................I...............I
II.............................................I...............I
II.............................................I...............I
II.............................................I...............I
II.............................................I...............I
I..............................................................I
I{{{{{{{{{{{{{{{{{{{{{{{{{{{{{{{{{{{{{{{{{{{{{{{{{{{{{{{{{{{{{{{
I..............................................................I
I......IIIIIIIIIIIIIIIIII......................................I
II.....I/............4.I................I......................I
II.....I...............I.........IIIIIIII......................I
II.....I.../IIIIIIIIIIII.IIIIII..I.............................I
I......I...I...I/.\......IFFFFI................................I
I......I...I....I..\.....IFFFFI......V.........................I
IIIIIIII...I....I...I....IFFFFI................................I
