I{{{{{{{{{{{{{{{{{{{{{{{{{{{{{{{{{{{{{{{{{{{{{{{{{{{{{{{{{{{{{{{
I..............................................................I
I......IIIIIIIIIIIIIIIIII......................................I
II.....I/............4.I................I......................I
II.....I...............I.........IIIIIIII......................I
II.....I.../IIIIIIIIIIII.IIIIII..I.............................I
I......I...I...I/.\......IFFFFI................................I
I......I...I....I..\.....IFFFFI......V.........................I
IIIIIIII...I....I...I....IFFFFI................................I
I.....IIIIIIIIIIIIIIIIIIIIFFFFIIIIIIIIIIIIIIIII................I
I.....I........I........\IFFFFI/....III.......I................I
I.....I........IIIIIIIIIIIIIIIIIIIIIII........I................I
I.....I........IFFFFFFFFFFFFFFFFFFFFII........I................I
I.....I........IFFFFFFFFFFFFFFFFFFFFII........I.....IXXXI......I
I.....I........I#############FFFFFFFII...CTFBM...IIIIFFFI.._...I
I.....I........I............#FFFFFFFII........I\I...IFFFI......I
I.....I........I............#FFFFFFFII........I.XX..IFFFI......I
I.....I........I.....nse....#FFFFFFFII........I.XX..IFFFI......I
I.....IIIIIIIII/............#FFFFFFFIIIIIIIIIIIIIIIIIIIIIIIIII/.
I.....FFFFFFFFF3............#FFFFFFFI#FFFFFFFFFFFFIFFFFFFFFFFFF1
I.....FFFFFFFFF3.w..........#FFFFFFFI#FFFFF][FFFFFIFFFFFFFFFeFF1
I.....FFFFFFFFF3............IFFFFFFFI#FFFFF[]FFFFFIFFFFFFFFFFFF1
I.....FFFFFFFFF3............#FFFFFFFI#FFFFFFFFFFFFIFFFFFFFFFFFF1
I.....IIIIIIIII\............IFFFFFFFIIIIIIIIIIIIIIIIIIIIIIIIII\.
II....I........IIIIIIIIIIIIIIIIIIIIIII........II....IFFFI......I
II....I........IIIIIIIIIIIIIIIIIIIIIII........II....IFFFI......I
II....I........I....................II........II....IFFFI......I
II....I........I....................II........II...LIFFFI......I
II....I........I....................II........II....IXXXI......I
II\...I........I....................II........II...............I
IIIIIIIIIIIIIIIIIIIIIIIII\..../IIIIIIIIIIIIIIIIIIIIIIIIIIIIIIIII
I........................IXXXXI.........XXXXXXXXX..............I
I....=...................IFFFFI..........................#.....I
IIIIIIIIIIIIIIIIIIIIIIIIIIFFFFI....E..{}..................R.T..I
I.................FFFFFFFFFFFFI................................I
I.................FFFFFFFFFFFFI.........................C......I
I.................FFFFFFFFFFFFI................................I
IIIIIIIIIIIIIIIIIIIIIIIIIIIIIIIIIIIIIIIIIIIIIIIIIIIIIIIIIIIIIIII
IIIIIIIIIIIIIIIIIIIIIIIIIIIIIIIIIIIIIIIIIIIIIIIIIIIIIIIIIIIIIIII
I..............................................................I
I..............................................................I
I..............................................................I
I..............................................................I
I..............................................................I
I..............................................................I
I..............................................................I
I..............................................................I
I..............................................................I
I..............................................................I
I..............................................................I
I..............................................................I
I..............................................................I
I..............................................................I
I..............................................................I
I..............................................................I
I..............................................................I
I..............................................................I
I..............................................................I
II.............................................I...............I
II.............................................I...............I
II.............................................I...............I
II.............................................I...............I
II.............................................I...............I
I..............................................................I
