IIIIIIIIIIIIIIIIIIIVVVVVVVVVVVVV
IF................IVVVVVVVVVVVVV
IF.............TTTIVVVVVVVVVVVVV
M..............TBIIVVVVVVVVVVVVV
M.T............TTIIVVVVVVVVVVVVV
M.TC..T..........IIVVVVVVVVVVVVV
M.T...TC.........IIVVVVVVVVVVVVV
M.....T..........\IIIIIIIIII/XVV
M..T..............FFFFFFFFFF1XVV
M..TC.............FFFFFFFFFF1XVV
M..T....T.........FFFFFFFeFF1XVV
M.......TC........FFFFFFFFFF1XVV
I.......T......../IIIIIIIIII\XVV
ITTTTTTTTTTTTTTTTIIVVVVVVVVVVVVV
VVVVVVVVVVVVVVVVVVVVVVVVVVVVVVVV
VVVVVVVVVVVVVVVVVVVVVVVVVVVVVVVV
VVVVVVVVVVVVVVVVVVVVVVVVVVVVVVVV
VVVVVVVVVVVVVVVVVVVVVVVVVVVVVVVV
VVVVVVVVVVVVVVVVVVVVVVVVVVVVVVVV
VVVVVVVVVVVVVVVVVVVVVVVVVVVVVVVV
VVVVVVVVVVVVVVVVVVVVVVVVVVVVVVVV
VVVVVVVVVVVVVVVVVVVVVVVVVVVVVVVV
VVVVVVVVVVVVVVVVVVVVVVVVVVVVVVVV
VVVVVVVVVVVVVVVVVVVVVVVVVVVVVVVV
VVVVVVVVVVVVVVVVVVVVVVVVVVVVVVVV
VVVVVVVVVVVVVVVVVVVVVVVVVVVVVVVV
VVVVVVVVVVVVVVVVVVVVVVVVVVVVVVVV
VVVVVVVVVVVVVVVVVVVVVVVVVVVVVVVV
VVVVVVVVVVVVVVVVVVVVVVVVVVVVVVVV
VVVVVVVVVVVVVVVVVVVVVVVVVVVVVVVV
VVVVVVVVVVVVVVVVVVVVVVVVVVVVVVVV
VVVVVVVVVVVVVVVVVVVVVVVVVVVVVVVV
