I{{{{{{{{{{{{{{{{{{{{{{{{{{{{{{{{{{{{{{{{{{{{{{{{{{{{{{{{{{{{{{{
I..............................................................I
I......IIIIIIIIIIIIIIIIII......................................I
II.....I/............4.I................I......................I
II.....I...............I.........IIIIIIII......................I
II.....I.../IIIIIIIIIIII.IXXXXI..I.............................I
I......I...I...I/.\......I0000I................................I
I......I...I....I..\.....IFFFFI......V.........................I
IIIIIIII...I....I...I....IFnFFI................................I
I.....IIIIIIIIIIIIIIIIIIIIFFFFIIIIIIIIIIIIIIIII................I
I.....I........I...I....\IFFFFI/....III.......I................I
I.....I........I...I................II........I................I
I.....I........I...I................II........I................I
I.....I........I...I................II........I.....IXXXI......I
I.....I...BF...I...I................II........III...IFFFI.._...I
I.....I........I...I................II........I\I...IFFFI......I
I.....I...CM...I...I................II........I.XX..IFFFI......I
I.....I.....T..I...I................II........I.XX..IFFFI......I
I.....IIIIIIIII/...I................IIIIIIIIIII/F\II/FFF\IIIII/.
I.....FFFFFFFFF....I................IFFFFFFFFFFFFFFFFFFFFFFFFFFF
I.....FFFFFFFFF....I................IFFFFFFFFFFFFFFFFFFFFFFFFFFF
I.....FFFFFFFFF....I................IFFFFFFFFFFFFFFFFFFFFFFFFFFF
I.....FFFFFFFFF....I................IFFFFFFFFFFFFFFFFFFFFFFFFFFF
I.....IIIIIIIII\...I................IIIIIIIIIII\F/II\FFF/IIIII\.
II....I........I...I................II........II....IFFFI......I
II....I........IIIIIIIIIIIIIIIIIIIIIII........II....IFFFI......I
II....I........I....................II........II....IFFFI......I
II....I........I....................II........II...LIFFFI......I
II....I........I................T...II........II....IXXXI......I
II\...I........I....................II........II...............I
IIIIIIIIIIIIIIIIIIIIIIIII\..../IIIIIIIIIIIIIIIIIIIIIIIIIIIIIIIII
I........................IXXXXI.........XXXXXXXXX..............I
I....=...................IFFFFI..........................#.....I
IIIIIIIIIIIIIIIIIIIIIIIIIIFFFFI....E..{}..................R.T..I
I.................FFFFFFFFFFFFI................................I
I.................FFFFFFFFFFFFI.........................C......I
I.................FFFFFFFFFFFFI................................I
IIIIIIIIIIIIIIIIIIIIIIIIIIIIIIIIIIIIIIIIIIIIIIIIIIIIIIIIIIIIIIII
IIIIIIIIIIIIIIIIIIIIIIIIIIIIIIIIIIIIIIIIIIIIIIIIIIIIIIIIIIIIIIII
I..............................................................I
I..............................................................I
I..............................................................I
I..............................................................I
I..............................................................I
I..............................................................I
I..............................................................I
I..............................................................I
I..............................................................I
I..............................................................I
I..............................................................I
I..............................................................I
I..............................................................I
I..............................................................I
I..............................................................I
I..............................................................I
I..............................................................I
I..............................................................I
I..............................................................I
II.............................................I...............I
II.............................................I...............I
II.............................................I...............I
II.............................................I...............I
II.............................................I...............I
I..............................................................I
