IIIIIIIIIIIIIIIIIIIIIIIIIIIIIIIIIIIIIIIIIIIIIIIIIIIIIIIIIIIIIIII
I..............................................................I
I..............................................................I
I..............................................................I
I..............................................................I
I..............................................................I
I..............................................................I
I..............................................................I
I..............................................................I
I..............................................................I
I..............................................................I
I..............................................................I
I..............................................................I
I..............................................................I
I..............................................................I
I..............................................................I
I..............................................................I
I..............................................................I
I..............................................................I
I..............................................................I
II.............................................I...............I
II.............................................I...............I
II.............................................I...............I
II.............................................I...............I
II.............................................I...............I
I..............................................................I
I{{{{{{{{{{{{{{{{{{{{{{{{{{{{{{{{{{{{{{{{{{{{{{{{{{{{{{{{{{{{{{{
I..............................................................I
I......IIIIIIIIIIIIIIIIII......................................I
II.....I/............4.I................I......................I
II.....I...............I.........IIIIIIII......................I
II.....I.../IIIIIIIIIIII.IIIIII..I.............................I
I......I...I...I/.\......IFFFFI................................I
I......I...I....I..\.....IFFFFI......V.........................I
IIIIIIII...I....I...I....IFFFFI................................I
I.....IIIIIIIIIIIIIIIIIIIIFFFFIIIIIIIIIIIIIIIII................I
I.....I........I........\IFFFFI/....III.......I................I
I.....I........IIIIIIIIIIIIIIIIIIIIIII........I................I
I.....I........I....................II........I................I
I.....I........I....................II........I.....IXXXI......I
I.....I....B...I....................II........III...IFFFI.._...I
I.....I........I....................II........I\I...IFFFI......I
I.....I...CTF..I....................II........I.XX..IFFFI......I
I.....I........I....................II........I.XX..IFFFI......I
I.....IIIIIIIII/....................\IIIIIIIIII/F\II/FFF\IIIII/.
I.....FFFFFFFFF......................FFFFFFFFFFFFFFFFFFFFFFFFFFF
I.....FFFFFFFFF......................FFFFFFFFFFFFFFFFFFFFFFFFFFF
I.....FFFFFFFFF......................FFFFFFFFFFFFFFFFFFFFFFFFFFF
I.....FFFFFFFFF.....4................FFFFFFFFFFFFFFFFFFFFFFFFFFF
I.....IIIIIIIII\..................../IIIIIIIIII\F/II\FFF/IIIII\.
II....I........I....................II........II....IFFFI......I
II....I........IIIIIIIIIIIIIIIIIIIIIII........II....IFFFI......I
II....I........I....................II........II....IFFFI......I
II....I........I.............M......II........II...LIFFFI......I
II....I........I....................II........II....IXXXI......I
II\...I........I....................II........II...............I
IIIIIIIIIIIIIIIIIIIIIIIII\..../IIIIIIIIIIIIIIIIIIIIIIIIIIIIIIIII
I........................IXXXXI.........XXXXXXXXX..............I
I....=...................IFFFFI..........................#.....I
IIIIIIIIIIIIIIIIIIIIIIIIIIFFFFI....E..{}..................R.T..I
I.................FFFFFFFFFFFFI................................I
I.................FFFFFFFFFFFFI.........................C......I
I.................FFFFFFFFFFFFI................................I
IIIIIIIIIIIIIIIIIIIIIIIIIIIIIIIIIIIIIIIIIIIIIIIIIIIIIIIIIIIIIIII
