IIIIIIIIIIIII,,,,,,,,,,,,,,,,,,,
IFFFFF......I,,,,,,,,,,,,,,,,,,,
IFFFFF......I,,,,,,,,,,,,,,,,,,,
I...........I,,,,,,,,,,,,,,,,,,,
ILLLLLLLLLLLI,,,,,,,,,,,,,,,,,,,
IL_________LI,,,,,,,,,,,,,,,,,,,
IL_________LI,,,,,,,,,,,,,,,,,,,
IL_________LI,,,,,,,,,,,,,,,,,,,
IL_________LI,,,,,,,,,,,,,,,,,,,
IL___s_____LI,,,,,,,,,,,,,,,,,,,
ILLLLLLLLLLLI,,,,,,,,,,,,,,,,,,,
IIIII222IIIII,,,,,,,,,,,,,,,,,,,
,,,,IXXXI,,,,,,,,,,,,,,,,,,,,,,,
,,,,,,,,,,,,,,,,,,,,,,,,,,,,,,,,
,,,,,,,,,,,,,,,,,,,,,,,,,,,,,,,,
,,,,,,,,,,,,,,,,,,,,,,,,,,,,,,,,
,,,,,,,,,,,,,,,,,,,,,,,,,,,,,,,,
,,,,,,,,,,,,,,,,,,,,,,,,,,,,,,,,
,,,,,,,,,,,,,,,,,,,,,,,,,,,,,,,,
,,,,,,,,,,,,,,,,,,,,,,,,,,,,,,,,
,,,,,,,,,,,,,,,,,,,,,,,,,,,,,,,,
,,,,,,,,,,,,,,,,,,,,,,,,,,,,,,,,
,,,,,,,,,,,,,,,,,,,,,,,,,,,,,,,,
,,,,,,,,,,,,,,,,,,,,,,,,,,,,,,,,
,,,,,,,,,,,,,,,,,,,,,,,,,,,,,,,,
,,,,,,,,,,,,,,,,,,,,,,,,,,,,,,,,
,,,,,,,,,,,,,,,,,,,,,,,,,,,,,,,,
,,,,,,,,,,,,,,,,,,,,,,,,,,,,,,,,
,,,,,,,,,,,,,,,,,,,,,,,,,,,,,,,,
,,,,,,,,,,,,,,,,,,,,,,,,,,,,,,,,
,,,,,,,,,,,,,,,,,,,,,,,,,,,,,,,,
,,,,,,,,,,,,,,,,,,,,,,,,,,,,,,,,
