I{{{{{{{{{{{{{{{{{{{{{{{{{{{{{{{{{{{{{{{{{{{{{{{{{{{{{{{{{{{{{{{
I..............................................................I
I......IIIIIIIIIIIIIIIIII......................................I
II.....I/............4.I................I......................I
II.....I...............I.........IIIIIIII......................I
II.....I.../IIIIIIIIIIII.IIIIII..I.............................I
I......I...I...I/.\......IFFFFI................................I
I......I...I....I..\.....IFFFFI......V.........................I
IIIIIIII...I....I...I....IFFFFI................................I
I.....IIIIIIIIIIIIIIIIIIIIFFFFIIIIIIIIIIIIIIIII.........IBBBBBBI
I.....I........I........\IFFFFI/....III.......I.........I000000I
I.....I........I...IIIIIIIIIIIIIIIIIII........I.........I......I
I.....I........I...IFFFFFFFFFFFFFFFFII........I.........I..n...I
I.....I........I...I................II........I.....IXXXI......I
I.....I.MB.....I...I................II........III...IFFFI......I
I.....I........I...I...............III........I\I...IFFFI......I
I.....I........I...I..C.............II........I.XX..IFFFI......I
I.....I........I...I.TTTTTTT........II........I.XX..IFFFI......I
I.....IIIIIIIII/...I.......TC.......\IIIIIIIIIIIIIIIIIIIIPPPPPPI
I.....FFFFFFFFF....I.......T.........PFFFFFFFFFFFFFFFFFFFFFFFFFI
I.....FFFFFFFFF....I.......T.........PFFFFFFFFFFFFFFFFFFFFFFFFFI
I.....FFFFFFFFF....I.......T.........PFFFFFFFFFFFFFFFFFFFFFFFFFI
I.....FFFFFFFFF....I.TTTTTTTC........PFFFFFFFFFFFFFFFFFFFFFFFFFI
I.....IIIIIIIII\...I................/IIIIIIIIIIIIIIIIIIIIIIIIIII
II....I........I...ITTTTTTTTTTTTTTTTII........II....IFFFI......I
II....I........IIIIIIIIIIIIIIIIIIIIIII........II....IFFFI......I
II....I........I....................II........II....IFFFI......I
II....I........I....................II........II...LIFFFI......I
II....I........I....................II........II....IXXXI......I
II\...I........I....................II........II...............I
IIIIIIIIIIIIIIIIIIIIIIIII\..../IIIIIIIIIIIIIIIIIIIIIIIIIIIIIIIII
I........................IXXXXI.........XXXXXXXXX..............I
I....=...................IFFFFI..........................#.....I
IIIIIIIIIIIIIIIIIIIIIIIIIIFFFFI....E..{}..................R.T..I
I.................FFFFFFFFFFFFI................................I
I.................FFFFFFFFFFFFI.........................C......I
I.................FFFFFFFFFFFFI................................I
IIIIIIIIIIIIIIIIIIIIIIIIIIIIIIIIIIIIIIIIIIIIIIIIIIIIIIIIIIIIIIII
IIIIIIIIIIIIIIIIIIIIIIIIIIIIIIIIIIIIIIIIIIIIIIIIIIIIIIIIIIIIIIII
I..............................................................I
I..............................................................I
I..............................................................I
I..............................................................I
I..............................................................I
I..............................................................I
I..............................................................I
I..............................................................I
I..............................................................I
I..............................................................I
I..............................................................I
I..............................................................I
I..............................................................I
I..............................................................I
I..............................................................I
I..............................................................I
I..............................................................I
I..............................................................I
I..............................................................I
II.............................................I...............I
II.............................................I...............I
II.............................................I...............I
II.............................................I...............I
II.............................................I...............I
I..............................................................I
