IIIIIIIIIIIIIIIIIIIIIIIIIIIIIIIIIIIIIIIIIIIIIIIIIIIIIIIIIIIIIIII
I..............................................................I
I..............................................................I
I..............................................................I
I..............................................................I
I..............................................................I
I..............................................................I
I..............................................................I
I..............................................................I
I..............................................................I
I..............................................................I
I..............................................................I
I..............................................................I
I..............................................................I
I..............................................................I
I..............................................................I
I..............................................................I
I..............................................................I
I..............................................................I
I..............................................................I
II.............................................I...............I
II.............................................I...............I
II.............................................I...............I
II.............................................I...............I
II.............................................I...............I
I..............................................................I
I{{{{{{{{{{{{{{{{{{{{{{{{{{{{{{{{{{{{{{{{{{{{{{{{{{{{{{{{{{{{{{{
I..............................................................I
I......IIIIIIIIIIIIIIIIII......................................I
II.....I/............4.I................I......................I
II.....I...............I.........IIIIIIII......................I
II.....I.../IIIIIIIIIIII.IIIIII..I.............................I
I......I...I...I/.\......IFFFFI................................I
I......I...I....I..\.....IFFFFI......V.........................I
IIIIIIII...I....I...I....IFFFFI................................I
I.....IIIIIIIIIIIIIIIIIIIIFFFFIIIIIIIIIIIIIIIII................I
I.....I........I........\IFFFFI/....III.......I................I
I.....I........I..........0000......II........I................I
I.....I........I....................II........I................I
I.....I........I...........n........II........I.....IXXXI......I
I.....I........I....................II........III...IFFFI.._...I
I.....I........I......LLLLLLLL......II........I\I...IFFFI......I
I.....I........I......L______L......II........I.XX..IFFFI......I
I.....I........I......L______L......II........I.XX..IFFFI......I
I.....IIIIIIIII/......L______L......\IIIIIIIIII/F\II/FFF\IIIII/.
I.....FFFFFFFFF3......L______L......1FFFFFFFFFFFFFFFFFFFFFFFFFFF
I.....FFFFFFFFF3.w....L______L....e.1FFFFFFFFFFFFFFFFFFFFFFFFFFF
I.....FFFFFFFFF3......L______L......1FFFFFFFFFFFFFFFFFFFFFFFFFFF
I.....FFFFFFFFF3......LLLLLLLL......1FFFFFFFFFFFFFFFFFFFFFFFFFFF
I.....IIIIIIIII\..................../IIIIIIIIII\F/II\FFF/IIIII\.
II....I........I....................II........II....IFFFI......I
II....I........I....................II........II....IFFFI......I
II....I........I....................II........II....IFFFI......I
II....I........I....................II........II...LIFFFI......I
II....I........I...........s........II........II....IXXXI......I
II\...I........I....................II........II...............I
IIIIIIIIIIIIIIIIIIIIIIIII\2222/IIIIIIIIIIIIIIIIIIIIIIIIIIIIIIIII
I........................IXXXXI.........XXXXXXXXX..............I
I....=...................IFFFFI..........................#.....I
IIIIIIIIIIIIIIIIIIIIIIIIIIFFFFI....ESZ{}............()....R.T..I
I.................FFFFFFFFFFFFI................................I
I.................FFFFFFFFFFFFI.........................C......I
I.................FFFFFFFFFFFFI................................I
IIIIIIIIIIIIIIIIIIIIIIIIIIIIIIIIIIIIIIIIIIIIIIIIIIIIIIIIIIIIIIII
