OOOOOOOOOOOOOOOOOOOOOOTOO/\TTIITTTOOTTTIIIIIIIIIIIIIIIIIIIIIIIII
OOOOOOOOOTT\T/\/00\TT/0\/0000\/000\/00TODDDDDDDDDDDDDDDDDDDDDDD1
OOOOOOOOO/0000000000000000000000000000\TDDDDDDDDDDDDDDDDDDDDDDD1
OOOOTTOOOT00WWWWWWWWWWWWWWWWWWWW0000000TDDDDDDDDDDDDDDDDDDDDDDD1
OOT/00\TT000WDDDDDDDDDDDDDDDDDDW0000000TDDDDDDDDDDDDDDDDDDDDDDD1
TT0000000000WDDDDDDS||||||_||||||||||0/TDDDDDDDDDDDDDDDDDDDDDDD1
WWWWWWWWWWWWWDDDDDDS|--Y-----|DDDDDD|0\TDDDDDDDDDDDDDDDDDDDDDDD1
XDDDfDDDDDDDDDDDDDDS|--Y-----|DDDDDD|00TDDDDDDDDDDDDDDDDDDDDDDD1
XDDDDDDDDDDDDDDDDDDS|--Y-----_fDDDDD|/\TDDDDDDDDDDDDDDDDDDDDDDD1
XDDDDDDDDSSSSSSSSSSSYYYYYYYYYYYYYYY~Y00TDDDDDDDDDDDDDDDDDDDDDDD1
IIFFFFFFFIIIIIIIIIIIqII][=d===B=====Y111DDDDDDDDDDDDDDDDDDDDDDD1
MBBBBBBBBBBB===][kzNNzk[]d====B=====ISD1DDDDDDDDDDDDDDDDDDDDDDD1
I==========B=e=[]kzzzzkKd=====B=====ISD1DDDDDDDDDDDDDDDDDDDDDDD1
I==========B=====szzzzk][c====Be====~SD1DDDDDDDDDDDDDDDDDDDDDDD1
I========][IIIIIIIIIIII[]====IMIIIIIISD1DDDDDDDDDDDDDDDDDDDDDDD1
I========[]I}{DDDDDDfDIII^^IIIICDfSSSSD1DDDDDDDDDDDDDDDDDDDDDDD1
IBBBBBBBBBBI{}DDDDDDDDDDDDDDDDDDDDDDDDD1DDDDDDDDDDDDDDDDDDDDDDD1
I========e=IDDDDDDDDDDDDDDDDDDDDDDDDDDD1DDDDDDDDDDDDDDDDDDDDDDD1
I==========IDDDSSSSSSSSSSSSSSSSSSSSSSSD1DDDDDDDDDDDDDDDDDDDDDDD1
IIIIIIIIIIIIDDDSIIIIIIIIIIIIIIIIIIIIIIIIDDDDDDDDDDDDDDDDDDDDDDD1
1DDDDDDDDDDDDDDSI=====B=====c======B===IDDDDDDDDDDDDDDDDDDDDDDD1
1DDfDDDDDDDDDDDSI=====B==d=========B===IDDDDDDDDDDDDDDDDDDDDDDD1
1DDDDDDDDDDDDDDSIBBBBBBBBBBBBBBBBBBIBBBIDDDDDDDDDDDDDDDDDDDDDDD1
IIIIIIIIIIIIISDSI=====B=======B===dI===IDDDDDDDDDDDDDDDDDDDDDDD1
IDIDDDDDDDDDISDSI=====B=======Be=dcI===IDDDDDDDDDDDDDDDDDDDDDDD1
IDIDDDDDDDDD^DDSIBBBBBBIIIIIIIIIIIII===IDDDDDDDDDDDDDDDDDDDDDDD1
IDIDDDDDDDDD^DDSI======I][d===B========IDDDDDDDDDDDDDDDDDDDDDDD1
IDIDDDDDDDDDISDSI=====eI[]====B========IDDDDDDDDDDDDDDDDDDDDDDD1
IDIDDDDDDDDDISDSIE====dI======B========IDDDDDDDDDDDDDDDDDDDDDDD1
IDIYYYYYYYYYYSDSY#YQYYYYBBBBBBBBBBBB===IDDDDDDDDDDDDDDDDDDDDDDD1
IDIDDDDDDDDDYSDSY?=====Y===========B=t=QDDDDDDDDDDDDDDDDDDDDDDD1
IDIDDDDDDDDDYSDSY======YIMI==I=====B=yeIDDDDDDDDDDDDDDDDDDDDDDD1
IDIDDDDDDDDDYSDSYYYYYYYY^^IFFIIIIIIIIIIIDDDDDDDDDDDDDDDDDDDDDDD1
IDIDDDDDDDDDYSDSSSSSSSSSSSSDDSSSSSSSSSSDDDDDDDDDDDDDDDDDDDDDDDD1
IDIDDDDDDDDDYSDDDDDDDDDDDDDDDDDDDDD}{DSDDDDDDDDDDDDDDDDDDDDDDDD1
IDIDDDDDDDDDYSDDDDDDDDDDDDDDDDDDDDD{}DSDDDDDDDDDDDDDDDDDDDDDDDD1
IYYYYYYYYYYYYSCDDDDDDDDDDDDDDDDDDCDDDDSDDDDDDDDDDDDDDDDDDDDDDDD1
1DDDDDDDDDDDDSDDDDDDDDDDDDDDDDDDDDDDDDSDDDDDDDDDDDDDDDDDDDDDDDD1
1DDDDDDDDDDDDSSS4SSSSSSSSSSSSSSSSSSSSSSDDDDDDDDDDDDDDDDDDDDDDDD1
1DDDDDDDDDDDDSSS4SSSSSSSSSSSSSSSSSSSSSSDDDDDDDDDDDDDDDDDDDDDDDD1
1DDDDDDDDDDDDSSS4SSSSSSSSSSSSSSSSSSSSSSDDDDDDDDDDDDDDDDDDDDDDDD1
1DDDDDDDDDDDDSSS4SSSSSSSSSSSSSSSSSSSSSSDDDDDDDDDDDDDDDDDDDDDDDD1
1DDDDDDDDDDDDSSS4SSSSSSSSSSSSSSSSSSSSSSDDDDDDDDDDDDDDDDDDDDDDDD1
1DDDDDDDDDDDDSSS4SSSSSSSSSSSSSSSSSSSSSSDDDDDDDDDDDDDDDDDDDDDDDD1
1DDDDDDDDDDDDSSS4SSSSSSSSSSSSSSSSSSSSSSDDDDDDDDDDDDDDDDDDDDDDDD1
1DDDDDDDDDDDDSSS4SSSSSSSSSSSSSSSSSSSSSSDDDDDDDDDDDDDDDDDDDDDDDD1
1DDDDDDDDDDDDSSS4SSSSSSSSSSSSSSSSSSSSSSDDDDDDDDDDDDDDDDDDDDDDDD1
1DDDDDDDDDDDDSSS4SSSSSSSSSSSSSSSSSSSSSSDDDDDDDDDDDDDDDDDDDDDDDD1
1DDDDDDDDDDDDSSS4SSSSSSSSSSSSSSSSSSSSSSDDDDDDDDDDDDDDDDDDDDDDDD1
1DDDDDDDDDDDDSSS4SSSSSSSSSSSSSSSSSSSSSSDDDDDDDDDDDDDDDDDDDDDDDD1
1DDDDDDDDDDDDSSS4SSSSSSSSSSSSSSSSSSSSSSDDDDDDDDDDDDDDDDDDDDDDDD1
1DDDDDDDDDDDDSSS4SSSSSSSSSSSSSSSSSSSSSSDDDDDDDDDDDDDDDDDDDDDDDD1
1DDDDDDDDDDDDSSS4SSSSSSSSSSSSSSSSSSSSSSDDDDDDDDDDDDDDDDDDDDDDDD1
1DDDDDDDDDDDDSSS4SSSSSSSSSSSSSSSSSSSSSSDDDDDDDDDDDDDDDDDDDDDDDD1
1DDDDDDDDDDDDSSS4SSSSSSSSSSSSSSSSSSSSSSDDDDDDDDDDDDDDDDDDDDDDDD1
1DDDDDDDDDDDDSSS4SSSSSSSSSSSSSSSSSSSSSSDDDDDDDDDDDDDDDDDDDDDDDD1
1DDDDDDDDDDDDSSS4SSSSSSSSSSSSSSSSSSSSSSDDDDDDDDDDDDDDDDDDDDDDDD1
1DDDDDDDDDDDDSSS4SSSSSSSSSSSSSSSSSSSSSSDDDDDDDDDDDDDDDDDDDDDDDD1
1DDDDDDDDDDDDSSS4SsSSSSSSSSSSSSSSSSSSSSDDDDDDDDDDDDDDDDDDDDDDDD1
1DDDDDDDDDDDDSSS4SSSSSSSSSSSSSSSSSSSSSSDDDDDDDDDDDDDDDDDDDDDDDD1
1DDDDDDDDDDDDSSS4SSSSSSSSSSSSSSSSSSSSSSDDDDDDDDDDDDDDDDDDDDDDDD1
1DDDDDDDDDDDDSSS4SSSSSSSSSSSSSSSSSSSSSSDDDDDDDDDDDDDDDDDDDDDDDD1
1DDDDDDDDDDDDSSS4SSSSSSSSSSSSSSSSSSSSSSDDDDDDDDDDDDDDDDDDDDDDDD1
11111111111111111XXXXm111111111111111111111111111111111111111111
