I.....IIIIIIIIIIIIIIIIIIIIFFFFIIIIIIIIIIIIIIIII................I
I.....I........I...I....\IFFFFI/....III.......I................I
I.....I........I...I......0000.....LII........I................I
I.....I........I...I...............LII........I................I
I.....I........I...I.......n.......LII........I.....IXXXI......I
I.....I...BF...I...I......sw.......LII........III...IFFFI.._...I
I.....I........I...I.......e........II........I\I...IFFFI......I
I.....I...CM...I...IMMMMMMMMMMMMMMMMII........I.XX..IFFFI......I
I.....I.....T..I...ISSSSSSSSSSSSSSSSII........I.XX..IFFFI......I
I.....IIIIIIIII/...IXXXSSSSSSSSSSSSSIIIIIIIIIII/F\II/FFF\IIIII/.
I.....FFFFFFFFF....IXXXSSSSSS}SSS}SSIFFFFFFFFFFFFFFFFFFFFFFFFFFF
I.....FFFFFFFFF....IXXXSSSSSSS}SSS}SIFFFFFFFFFFFFFFFFFFFFFFFFFFF
I.....FFFFFFFFF....ISSSI###ISSSISSSIIFFFFFFFFFFFFFFFFFFFFFFFFFFF
I.....FFFFFFFFF....ISTSIIIIISTSISTSIIFFFFFFFFFFFFFFFFFFFFFFFFFFF
I.....IIIIIIIII\...ISRSIIIIISRSISRSIII.IIIIIIII\F/II\FFF/IIIII\.
II....I........I...ISSSIIIIISSSISSSIII........II....IFFFI......I
II....I........IIIIIIIIIIIIIIIIIIIIIII........II....IFFFI......I
II....I........I....................II........II....IFFFI......I
II....I........I....................II........II...LIFFFI......I
II....I........I................T...II........II....IXXXI......I
II\...I........I....................II........II...............I
IIIIIIIIIIIIIIIIIIIIIIIII\..../IIIIIIIIIIIIIIIIIIIIIIIIIIIIIIIII
I........................IXXXXI.........XXXXXXXXX..............I
I....=...................IFFFFI..........................#.....I
IIIIIIIIIIIIIIIIIIIIIIIIIIFFFFI....E..{}..................R.T..I
I.................FFFFFFFFFFFFI................................I
I.................FFFFFFFFFFFFI.........................C......I
I.................FFFFFFFFFFFFI................................I
IIIIIIIIIIIIIIIIIIIIIIIIIIIIIIIIIIIIIIIIIIIIIIIIIIIIIIIIIIIIIIII
IIIIIIIIIIIIIIIIIIIIIIIIIIIIIIIIIIIIIIIIIIIIIIIIIIIIIIIIIIIIIIII
I..............................................................I
I..............................................................I
I..............................................................I
I..............................................................I
I..............................................................I
I..............................................................I
I..............................................................I
I..............................................................I
I..............................................................I
I..............................................................I
I..............................................................I
I..............................................................I
I..............................................................I
I..............................................................I
I..............................................................I
I..............................................................I
I..............................................................I
I..............................................................I
I..............................................................I
II.............................................I...............I
II.............................................I...............I
II.............................................I...............I
II.............................................I...............I
II.............................................I...............I
I..............................................................I
I{{{{{{{{{{{{{{{{{{{{{{{{{{{{{{{{{{{{{{{{{{{{{{{{{{{{{{{{{{{{{{{
I..............................................................I
I......IIIIIIIIIIIIIIIIII......................................I
II.....I/............4.I................I......................I
II.....I...............I.........IIIIIIII......................I
II.....I.../IIIIIIIIIIII.IIIIII..I.............................I
I......I...I...I/.\......IFFFFI................................I
I......I...I....I..\.....IFFFFI......V.........................I
IIIIIIII...I....I...I....IFFFFI................................I
