,,,,,,,,,,,,,IXXXXI,,,,,,,,,,,,,
,,,IIIIIIIIIIPFFFFPIIIIII,,,,,,,
,,,I..ZLS...\IFFFFI/....I,,,,,,,
,,,I.........00000......I,,,,,,,
,,,I....................I,,,,,,,
,,,I....................I,,,,,,,
,,,I...........n........I,,,,,,,
,,,I....................I,,,,,,,
,,,I.......444444.......I,,,,,,,
III/.......444444.......I,,,,,,,
XFF3.......444444.......\III,,,,
XFF3.w.....444444.......1FFX,,,,
XFF3.......444444.......1FFX,,,,
III\.......444444...e...1FFX,,,,
,,,I.........s..........1FFX,,,,
,,,I..................../III,,,,
,,,IIIIIIIIIIIIIIIIIIIIIII,,,,,,
,,,,,,,,,,,,,,,,,,,,,,,,,,,,,,,,
,,,,,,,,,,,,,,,,,,,,,,,,,,,,,,,,
,,,,,,,,,,,,,,,,,,,,,,,,,,,,,,,,
,,,,,,,,,,,,,,,,,,,,,,,,,,,,,,,,
,,,,,,,,,,,,,,,,,,,,,,,,,,,,,,,,
,,,,,,,,,,,,,,,,,,,,,,,,,,,,,,,,
,,,,,,,,,,,,,,,,,,,,,,,,,,,,,,,,
,,,,,,,,,,,,,,,,,,,,,,,,,,,,,,,,
,,,,,,,,,,,,,,,,,,,,,,,,,,,,,,,,
,,,,,,,,,,,,,,,,,,,,,,,,,,,,,,,,
,,,,,,,,,,,,,,,,,,,,,,,,,,,,,,,,
,,,,,,,,,,,,,,,,,,,,,,,,,,,,,,,,
,,,,,,,,,,,,,,,,,,,,,,,,,,,,,,,,
,,,,,,,,,,,,,,,,,,,,,,,,,,,,,,,,
,,,,,,,,,,,,,,,,,,,,,,,,,,,,,,,,
