I{{{{{{{{{{{{{{{{{{{{{{{{{{{{{{{{{{{{{{{{{{{{{{{{{{{{{{{{{{{{{{{
I..............................................................I
I......IIIIIIIIIIIIIIIIII......................................I
II.....I/............4.I................I......................I
II.....I...............I.........IIIIIIII......................I
II.....I.../IIIIIIIIIIII.IIIIII..I.............................I
I......I...I...I/.\......IFFFFI................................I
I......I...I....I..\.....IFFFFI......V.........................I
IIIIIIII...I....I...I....IXXXXI................................I
I.....IIIIIIIIIIIIIIIIIIIPFFFFPIIIIIIIIIIIIIIII................I
I.....I........I..ZLS...\IFFFFI/....III.......I................I
I.....I........I.........00000......II........I................I
I.....I........I....................II........I................I
I.....I........I....................II........I.....IXXXI......I
I.....I........I...........n........II........III...IFFFI.._...I
I.....IFFF.....I....................II........I\I...IFFFI......I
II....IFFF.....I.......444444.......II........I.XX..IFFFI......I
I/....IFFFIIIII/.......444444.......II........I.XX..IFFFI......I
X.....IFFFFFFFF3.......444444.......\IIIIIIIIII/F\II/FFF\IIIII/.
X.....IFFFFFFFF3.w.....444444.......1FFXFFFFFFFFFFFFFFFFFFFFFFFF
X.....IFFFFFFFF3.......444444.......1FFXFFFFFFFFFFFFFFFFFFFFFFFF
X.....IIIIIIIII\.......444444...e...1FFXFFFFFFFFFFFFFFFFFFFFFFFF
X.....I........I.........s..........1FFXFFFFFFFFFFFFFFFFFFFFFFFF
I\....I........I..................../IIIIIIIIII\F/II\FFF/IIIII\.
II....I........IIIIIIIIIIIIIIIIIIIIIII........II....IFFFI......I
II....I........I....................II........II....IFFFI......I
II....I........I....................II........II....IFFFI......I
II....I........I....................II........II...LIFFFI......I
II....I........I....................II........II....IXXXI......I
II\...I........I....................II........II...............I
IIIIIIIIIIIIIIIIIIIIIIIIIIIIIIIIIIIIIIIIIIIIIIIIIIIIIIIIIIIIIIII
I........................IFFFFI.........XXXXXXXXX..............I
I....=...................IFFFFI..........................#.....I
IIIIIIIIIIIIIIIIIIIIIIIIIIFFFFI....ESZ{}............()....R.T..I
I.................FFFFFFFFFFFFI................................I
I.................FFFFFFFFFFFFI.........................C......I
I.................FFFFFFFFFFFFI................................I
IIIIIIIIIIIIIIIIIIIIIIIIIIIIIIIIIIIIIIIIIIIIIIIIIIIIIIIIIIIIIIII
IIIIIIIIIIIIIIIIIIIIIIIIIIIIIIIIIIIIIIIIIIIIIIIIIIIIIIIIIIIIIIII
I..............................................................I
I..............................................................I
I..............................................................I
I..............................................................I
I..............................................................I
I..............................................................I
I..............................................................I
I..............................................................I
I..............................................................I
I..............................................................I
I..............................................................I
I..............................................................I
I..............................................................I
I..............................................................I
I..............................................................I
I..............................................................I
I..............................................................I
I..............................................................I
I..............................................................I
II.............................................I...............I
II.............................................I...............I
II.............................................I...............I
II.............................................I...............I
II.............................................I...............I
I..............................................................I
