hhhhhhhhhIIIIIIIIIIIIIIIIIIIhhhhhIhhhhhh
1WWWWWWWWIF-_UUUUUUUUUUUUUUUUUUUXUUUUUUh
1GGGGGGGGIF-_UUUUUUUUUUU___IUUUUIUUUUUUh
1GGGGGGGGIF-_UUUUUUUUUUU_--IU4UUIUUUUUUh
1GGGGGGGGIF-_____________-FIhhhhIIIIIII1
1GGGGGGGGIF---------------FIGGGGGGGGGGG1
1GGGGGGGGIFFFFFFFFFFFFFFFFFIGGGGGGGGGGG1
1GGGGGGGGIIIIIIIIIJJIIIIIIIIGGGGGGGGGGG1
1GGGGGGGGGGGGGGGGGZZGGGGGGGGGGGGGGGGGGG1
1GGG/hhhhhhhGGGGGGSSGGGGGGGGGGGGGGGGGGG1
1G/h00?0h-F~SSSSSSSSGGGGGGIIIIIIIIIIIII1
1Ghhhh#hh_hhGGGGGGSSSSSSSS~FFhIUUcUUUUU1
1GhhcUEUUUh/GGGGGGSSGGGGGGIF-hIUUUUIWWW1
1GhQeUUUUUhGGGGGGGSSGGGGGGIF_hhhXhhIIIII
1G\IIIIIII/GGGGGGGSSGGGGGGIUUUUUUUUIK==I
1GGGGGGGGGGGGGGGGGSSGGGGGGIUUUUUUUUI===I
1GGGGGGGGGGGGGGGGGSSGGGGGGIUUUUUUcCIf==I
1GGGGGGGGGGGGGGGGGSSGGGGGGIUeUhhhhhI===I
1GGGGGGGGGGGGGGGGGSSGGGGGGIUUUhGGWWIII~I
1GGGGGGGGGGGGGGGGGSSGGGGGGIUUUhGGWGGGGS1
1GGGGSSSSSSSSGGGGGSSGGGGGGIUUUhGGWGGGGS1
1GGGGSllllllSGGGGGSSGGGGGGIUUUhGGWGGGGS1
1GGGGSl[LL]lSGGGGGSSGGGGGGIUUUhIIWGGGGS1
1GGGGSlL{}LlSGGGGGSSGGGGGGIUUUUUIWGGGGS1
1GGGGSlL}{LlSGGGGGSSGGGGGGIPCUUcIWGGGGS1
1GGGGSl]LL[lSGGGGGSSGGGGGGIIIIIIIWGGGGS1
1GGGGSllllllSGGGGGSSGGGGGGGGGGGGGWhhhh~1
1GGGGSSSSSSSSGGGGGSSGGGGGGSSSGGGGhhQhhF1
1GGGGGGSSGGGGGGGGGSSSSSSSSSHSGGGGhUUUI-1
1GGGGGGSSSSSSSSSSSSGGGGGGGSSSGGGGhUUeI_1
1GGGGGGGGGGGGGGGGGSGGGGGGGGGGGGGGhUUUUU1
1GGG/hhhhhhhGGGGGGShhhhhhhhhhhhGGhUUUUU1
1G/I1UUcI-F~SSSSSSShUUUUUUUUcchGGhUUUUU1
1GIIeUUII_hh\GGGGGGhUeUUUUUUUchGGhUUUUU1
1GIIUUUUUUUIIhhhhhhIUUUUUUUUUUhhhhcUUUUI
1GIIUUUUUUUUIUUUUUUUUUUUUUUUUUIUeUUUUUUI
IIUUUUUUUUUUUUUUUUUUUUUUUUUUUUIUUUUUUUII
IcUUUUUUUUUUUUUUUUUUUUUUUUUUUUUUUUUUUUcI
IccUUUUUUUUUIUUUUUUUUUUUUUUUUUUUUUUUUUcI
IhhhhhhhQhhhIIIIIIIIIIIIIIIIIIIIIIIIIIII