IIIIIIIIIIIIIIIIIIIIIIIIIIIIIIIIIIIIIIIIIIIIIIIIIIIIIIIIIIIIIIII
I..............................................................I
I..............................................................I
I..............................................................I
I..............................................................I
I..............................................................I
I..............................................................I
I..............................................................I
I..............................................................I
I..............................................................I
I..............................................................I
I..............................................................I
I..............................................................I
I..............................................................I
I..............................................................I
I..............................................................I
I..............................................................I
I..............................................................I
I..............................................................I
I..............................................................I
II.............................................I...............I
II.............................................I...............I
II.............................................I...............I
II.............................................I...............I
II.............................................I...............I
I..............................................................I
I{{{{{{{{{{{{{{{{{{{{{{{{{{{{{{{{{{{{{{{{{{{{{{{{{{{{{{{{{{{{{{{
I..............................................................I
I......IIIIIIIIIIIIIIIIII......................................I
II.....I/............4.I................I......................I
II.....I...............I.........IIIIIIII......................I
II.....I.../IIIIIIIIIIII.IIIIII..I.............................I
I......I...I...I/.\......IFFFFI................................I
I......I...I....I..\.....IFFFFI......V.........................I
IIIIIIII...I....I...I....IFFFFI................................I
I.....IIIIIIIIIIIIIIIIIIIIFsFFIIIIIIIIIIIIIIIII................I
I.....I........I........\IFFFFI/....III.......I................I
I.....I........I.........222222.....II........I................I
I.....I........I....................II........I................I
I.....I........I....................II........I.....IXXXI......I
I.....I........I....................II........III...IFFFI.._...I
I.....I........I....................II........I\I...IFFFI......I
II....I........I.......444444.......II........I.XX..IFFFI......I
I/....I........I.......444444.......II........I.XX..IFFFI......I
X.....I........I.......444444.......\IIIIIIIIII/F\II/FFF\IIIII/.
X.....I........I.......444444........FFFFFFFFFFFFFFFFFFFFFFFFFFF
X.....I........I.......444444........FFFFFFFFFFFFFFFFFFFFFFFFFFF
X.....I........I.......444444........FFFFFFFFFFFFFFFFFFFFFFFFFFF
X.....I........I.....................FFFFFFFFFFFFFFFFFFFFFFFFFFF
I\....I........I..................../IIIIIIIIII\F/II\FFF/IIIII\.
II....I........I....................II........II....IFFFI......I
II....I........I....................II........II....IFFFI......I
II....I........I....................II........II....IFFFI......I
II....I........I....................II........II...LIFFFI......I
II....I........I....................II........II....IXXXI......I
II\...I........I....................II........II...............I
IIIIIIIIIIIIIIIIIIIIIIIII\..../IIIIIIIIIIIIIIIIIIIIIIIIIIIIIIIII
I........................IFFFFI.........XXXXXXXXX..............I
I....=...................IFFFFI..........................#.....I
IIIIIIIIIIIIIIIIIIIIIIIIIIFFFFI....ESZ{}............()....R.T..I
I.................FFFFFFFFFFFFI................................I
I.................FFFFFFFFFFFFI.........................C......I
I.................FFFFFFFFFFFFI................................I
IIIIIIIIIIIIIIIIIIIIIIIIIIIIIIIIIIIIIIIIIIIIIIIIIIIIIIIIIIIIIIII
