YYYYYYYYYYYYYYYYYYYYYYYYYYYaYYYYkYYYYYYY
YFFFXFFFFFFFWG/I\GWFFFFFFYTtFFFFFFYFFFFY
yFFFYFFFFFFFAGIGIGAFFF[]FYtFFFFFFFYxYYYY
YYYYYdFFFFFFAG\I/GAFFF][FYFFFF[]FFFFFFFY
YddFFFFFFFFFWAAAAAWFFdFFFYFFFF][FFFFFFFY
YFFFFFFFFFFFFFFFFFFFFFFFFYdFFFFFFFFFFFFY
YFFFFFFFFFFFFFFFFFFFfFFFFYFFFFFfFFFFFFFY
YFFFFFFFFF[]FFYYYYYYYYYY~YFFFFYYYYYYYY~Y
YFFFFFFFFF][FFYtFFFFFFFFFYFFFFaPFFFFFFFY
YFFFFFFFFFFFFFYTFFFfFFFFFYFFFFYpFFFFFFFY
YFFFFFFFFFFfFFYtFFFFFFFFFYFFFFYTfFFFFFFY
YFFFFFFFFFFFFFYYaY~YYYYpPYFFFFYYYYFFFFFY
WWWFFWWWWWWWWWWWWWFWWWWWWWWALWWWFWFFWWWW
WGAFFAGGGGSGGCGGGAFAG{}GGGGGSG#FFAFFAGGW
WGAFFAGGG/I\GGGGGAFAG}{GGGGGSGWWWWFFWGGW
WGWFFWGGGIGIGGGGGWKWGGGGGGGGSG/I\AFFAGGW
WGAFFAGGG\I/GGGGG/I\GG/I\GGGSGIIIAFFAGGW
WGAFFAcGGGGGGGGGGIIAAAIIIGGGSG\I/AFFAGGW
WGWFFWGGGGGGGGGGG\I/GGIIIGGGSGGSGWFFWGGW
WGAFFAGG{}GGGGGGGGGGGG\I/GGGSG/I\AFFAGGW
WGAFFAGG}{GGGGG/IIIIIII\GGGGSGIIIAFFAGGW
WWWFFWWWWWWWWWGIGGGGGGGIGGGSSG\I/AFFAGGW
wTtFFFFFFFFPWWGIGGGGGGGIWWW-WWWWWWFFWWWW
WtFFFFFFFFFpWWWIGGGGGGGIWWY_YYYYYYFFYYYY
WWWALAAAAAAAWWG\IIIIIII/GWY____e_YFFFtta
Y_W______e__WWGGGGGGGGGGGWY______YFFFFtY
Y_#_________-SGGGGGGGGGGGH____/I\YFFFFFY
WWWWWWWWWWWWWSSSSSSSSSSSSH____I__YFFFFFY
Wv__________YWGGGGGGGGGGGWY___\_/YFFFFFY
W___________YWWIIIIIIIIWWWYYYYYYYYALAAAY
W___________YWGGGGGGCGGGSE#?_____Y_____Y
W___________-SGS/I\SGGGGSWW______Y_____Y
WWHHHHHHHHHWWSGSIIISGGGGSWYYYYYYYYe____Y
WGcC{}GGGGGGWSGS\I/SGGGGSWY____________Y
WGGj}{GGGGGGWSGGSSSSGGGGSWY__________YYW
WGGGiGGGGGGCWSGGS/III\GGSWY__________Y_W
WGGGGhGGG4GcWSGGSIIIIIGGSWY_________vY_W
WGGGGGgcGGGGWSSSS\III/SSS-_________YYY_W
WGGGGGGcCGGGWSSSSSSSSSSSSWY________#___W
WWIIIIIWWWWWWWWWWWWWWWWWWWYYYYYYYYYYWWWW