IIIIIIIIIIIIIIIIIIIIIIIIIIIIIIIIIIIIIIIIIIIIIIIIIIIIIIIIIIIIIIII
I..............................................................I
I..............................................................I
I..............................................................I
I..............................................................I
I..............................................................I
I..............................................................I
I..............................................................I
I..............................................................I
I..............................................................I
I..............................................................I
I..............................................................I
I..............................................................I
I..............................................................I
I..............................................................I
I..............................................................I
I..............................................................I
I..............................................................I
I..............................................................I
I..............................................................I
II.............................................I...............I
II.............................................I...............I
II.............................................I...............I
II.............................................I...............I
II.............................................I...............I
I..............................................................I
I{{{{{{{{{{{{{{{{{{{{{{{{{{{{{{{{{{{{{{{{{{{{{{{{{{{{{{{{{{{{{{{
I..............................................4...............I
I......IIIIIIIIIIIIIIIIII.......................IIIIIIIIIIIII..I
II.....I/..............I................I.......IFFFFF......I..I
II.....I...............I.........IIIIIIII.......IFFFFF......I..I
II.....I.../IIIIIIIIIIII.IIIIII..I..............I...........I..I
I......I...I...I/.\......IFFFFI.................ILLLLLLLLLLLI..I
I......I...I....I..\.....IFFFFI......V..........IL_________LI..I
IIIIIIII...I....I...I....IFFFFI.................IL_________LI..I
I.....IIIIIIIIIIIIIIIIIIIIFFFFIIIIIIIIIIIIIIIII.IL_________LI..I
I.....I........IIIIIIIIII/....\IIIIIII........I.IL_________LI..I
I.....I........I....................II........I.IL___s_____LI..I
I.....I........I....................II........I.ILLLLLLLLLLLI..I
I.....I........I....................II........I.IIIII222IIIII..I
I.....I........I....................II........III...IXXXI.._...I
I.....I........I....................II........I\I...IFFFI......I
II....I........I....................II........I.XX..IFFFI......I
I/....I........I....................II........I.XX..IFFFI......I
X.....I........I....................\IIIIIIIIII/F\II/FFF\IIIII/.
X.....I........I.....................FFFFFFFFFFFFFFFFFFFFFFFFFFF
X.....I........I.....................FFFFFFFFFFFFFFFFFFFFFFFFFFF
X.....I........I.....................FFFFFFFFFFFFFFFFFFFFFFFFFFF
X.....I........I.....................FFFFFFFFFFFFFFFFFFFFFFFFFFF
I\....I........I..................../IIIIIIIIII\F/II\FFF/IIIII\.
II....I........I....................II........II....IFFFI......I
II....I........I....................II........II....IFFFI......I
II....I........I....................II........II....IFFFI......I
II....I........I....................II........II...LIFFFI......I
II....I........I....................II........II....IXXXI......I
II\...I........I....................II........II...............I
IIIIIIIIIIIIIIIIIIIIIIIII\..../IIIIIIIIIIIIIIIIIIIIIIIIIIIIIIIII
I........................IFFFFI.........XXXXXXXXX..............I
I....=...................IFFFFI..........................#.....I
IIIIIIIIIIIIIIIIIIIIIIIIIIFFFFI....ESZ{}............()....R.T..I
I.................FFFFFFFFFFFFI................................I
I.................FFFFFFFFFFFFI.........................C......I
I.................FFFFFFFFFFFFI................................I
IIIIIIIIIIIIIIIIIIIIIIIIIIIIIIIIIIIIIIIIIIIIIIIIIIIIIIIIIIIIIIII
