IIIIIIIIIIIIIIIIIIIIIIIIIIIIIIIIIIIIIIIIIIIIIIIIIIIIIIIIIIIIIIII
I..............................................................I
I..............................................................I
I..............................................................I
I..............................................................I
I..............................................................I
I..............................................................I
I..............................................................I
I..............................................................I
I..............................................................I
I..............................................................I
I..............................................................I
I..............................................................I
I..............................................................I
II.............................................I...............I
II.............................................I...............I
II.............................................I...............I
II.............................................I...............I
II.............................................I...............I
I..............................................................I
I{{{{{{{{{{{{{{{{{{{{{{{{{{{{{{{{{{{{{{{{{{{{{{{{{{{{{{{{{{{{{{{
I..............................................................I
I......IIIIIIIIIIIIIIIIII.......................IIIIIIIIIIIII..I
II.....I/..............I................I.......IFFFFF......I..I
II.....I...............I.........IIIIIIII.......IFFFFF......I..I
II.....I.../IIIIIIIIIIII.IIIIII..I..............I...........I..I
I......I...I...I/.\......IFFFFI.................ILLLLLLLLLLLI..I
I......I...I....I..\.....IFFFFI......V..........IL_________LI..I
IIIIIIII...I....I...I....IFFFFI.................IL_________LI..I
I.....IIIIIIIIIIIIIIIIIIIIFFFFIIIIIIIIIIIIIIIII.IL_________LI..I
I.....I........IIIIIIIIII/....\IIIIIII........I.IL_________LI..I
I.....I........I....................II........I.IL_________LI..I
I.....I........I....................II........I.ILLLLLLLLLLLI..I
I.....I........I....................II........I.IIIIIXXXIIIII..I
I.....I........I....................II........III...IFFFI.._...I
I.....I........I....................II........I\I...IFFFI......I
II....I........I....................II........I.XX..IFFFI......I
I/....I........I....................II........I.XX..IFFFI......I
X.....I........I....................\IIIIIIIIII/F\II/FFF\IIIII/.
X.....I........I.....................FFFFFFFFFFFFFFFFFFFFFFFFFFF
X.....I........I.....................FFFFFFFFFFFFFFFFFFFFFFFFFFF
X.....I........I.....................FFFFFFFFFFFFFFFFFFFFFFFFFFF
X.....I........I.....................FFFFFFFFFFFFFFFFFFFFFFFFFFF
I\....I........I..................../IIIIIIIIII\F/II\FFF/IIIII\.
II....I........I....................II........II....IFFFI......I
II....I........I....................II........II....IFFFI......I
II....I........I....................II........II....IFFFI......I
II....I........I....................II........II...LIXXXI......I
II....I........I....................II........IIIIIII000IIIII..I
II\...I........I....................II........IILLLLLLLLLLLLI..I
IIIIIIIIIIIIIIIIIIIIIIIII\..../IIIIIIIIIIIIIIIIIL_____n____LIIII
I........................IFFFFI.........XXXXXXXIL__________LI..I
I....=...................IFFFFI................IL__________LIR.I
IIIIIIIIIIIIIIIIIIIIIIIIIIFFFFI....ESZ{}....#..IL__________LI..I
I.................FFFFFFFFFFFFI................IL__________LI..I
I.................FFFFFFFFFFFFI.............C..ILLLLLLLLLLLLI..I
I.................FFFFFFFFFFFFI................I............I..I
I..............................................I.......FFFFFI..I
I..........................................()..I.......FFFFFI..I
I..............................................IIIIIIIIIIIIIIT.I
I..............................................................I
I..............................................................I
I..............................................................I
IIIIIIIIIIIIIIIIIIIIIIIIIIIIIIIIIIIIIIIIIIIIIIIIIIIIIIIIIIIIIIII
