IIIIIIIIRRRRIIIIIIIIIIIIIIIIIIIIIIIIIIII
IUUUUUUUUUUUUUUUUIUUUUUUUUUUUUUUUUUUUUUI
IUUWWUUUUUUUUUUUUIUUUUUUUUUUUUUUUUUUUUUI
IUUWWUUUUUUUUUUUUIUUUUUCCCUUUUUUWUUUWUUI
IUUUCUUUUUUUUUUU/I\UUUUUCCUUUUUUUUCCUUUI
RUUUUUUUUUUUeUUUTTTUUUUUUUUUUUUUUUCUWUUI
RUUUUUUUUUUUUUUUUSUUUUUUUUUUUUUUUUUUUUUI
RUUUUUUUUCUUUUUUTTTUUUCUUUUUUUUUUUUUUUUI
RUUUUUUUUUUUUUUU\I/UUUUUUUWWUUUUUUUUUUUI
IUUUUUUUUUUUUUUUUIIIIIIIIIWWUUUUUUUUUUUI
IUUUIIIIIIIIIIIIIICCCCUUUUUUUUUUUUUUUUUI
IUUUWWUUUUUUUCCCCICCUUUUUUUCUUUUUUUUUUUI
IUUUWWUUUUUbUUCC/IIIIIIIII\UUUeUUUUUUUUI
pUUUUUUUUUUUUUU/Z/UUcPcUU\Z\UUUUUUUUUUUI
IUUUUUUUUUUUUU/Z/UUUUUUUUU\Z\UUUUUUUUUUI
IUUUUUUUUUUUU/Z/UUUUUUUUUUU\Z\UUUUUUUUUI
IUUUU/TUT\UU/Z/UUUUUUUUUUUUU\Z\UU/TUT\UI
IIIIITTSTIIIIIUUUUUUUKUUUUUUU\ZIIITSTIII
IUUUU\TUT/UU\Z\UUUUUUUUUUUUUU/IUU\TUT/UI
IUUUUUUUUUUUU\Z\UUUeUUUUUUUUUIIUUUUUUUUI
IUWWUUUUUUUUUU\Z\UUUUUUUUUUUUI/UUUUUUUUI
IUWWUUUUUUUUUUU\Z\UUqQqUU/ITSTUUUUUUUUUI
IUUUCUUUUUUUUUUU\IIIIIIIII/UUUUUUUUUUUUI
IUUUUUUUUUUUeUUUUUUUUUUUUIUUUUUUUUUUUUUI
hUUUUUUUUUUUUUUUUUUUUUUUUIUUUUUUUUUUUUUI
IUUUUCUUUUUUUCUUUUCUUUUUUIUUUUUWWUUUUUUI
IUUUUUUUUUUUUUUUUUUUUUUUUIIIIIIWWUUUUUUI
iiiiiiiiiiiiiiiWWWIUUUUUUIUUUUUUUUUUUUUI
iuuuuuuuuuuuuuiWWWUUUUUUUIUUUeUUUUUUUUUI
iuAAAAAuuuuuuuVUUUUUUUUUUIUUUUUUUUUUUUUI
iuAF-_uuuuuuuuVUUUUCUUUUUIUUUUUUUUUUUUUI
iuAFFFAuuuuuuuVUUUUUUUUUUIUUUUWWIIIIIIII
iiiFiiiiiiiiiiVUUUUUUUUUUIUUUUWWUUUUUUUI
111~111111111IIIIIIIIIIIIIUUUUUUUUUUUUUI
1GGGGGGGGGGGG1IUUUUUUUUUUIUUUUUUUWUWUUUI
1GGGGGGGGGGGG1IUUUUUUUUUUTUUUUUUUUUUUUUI
1GGG4GGGGGGGG1IUUUUUUUUU?#EUUUUUUWUWUUUI
1GGGGGGGGGGGG1IUUUUUUUUUUTUUUUcUUUUUUUUI
1GGGGGGGGGGGG1IUUUUUUUUUUIUUUUUUUUUUUUUI
1XXXX111111111IIIIIIIIIIIIIIIIIIIIIIIIII
