IIIIIIIIIIIIIIIIIIIIIIIIIIIIIIIIIIIIIIII
IUUUUUUUUUUUUUUUUIUUUUUUUUUUUUUUUUUUUUUI
IUUUUUUUUUWWUUUUUIUUUUUUUUUUUUUUUUUUUUUI
IUUUUUUUUUWWUUUUUIUUUUUbbbUUUUUUWUUUWUUI
IUUUUbUUUUUUUUUU/I\UUUUUbbUUUUUUUUbbUUUI
IUUUUUUUUUUUUUUUTTTUUUUUUUUUUUUUUUbUWUUI
IUUUUUUUUUUUUUUUU~UUUUUUUUUUUUUUUUUUUUUI
IUUUUUUUUbUUUUUUTTTUUUbUUUUUUUUUUUUUUUUI
IUUUUUUUUUUUUUUU\I/UUUUUUUWWUUUUUUUUUUUI
IUUUUUUUUUUUUUUUUIIIIIIIIIWWUUUUUUUUUUUI
IUUUIIIIIIIIIIIIIIbbbbUUUUUUUUUUUUUUUUUI
IUUUWWUUUUUUUbbbbIbbUUUUUUUbUUUUUUUUUUUI
IUUUWWUUUUUUUUbb/IIIIIIIII\UUUUUUUUUUUUI
IUUUUUUUUUUUUUU/Z/UUcPcUU\Z\UUUUUUUUUUUI
IUUUUUUUUUUUUU/Z/UUUUUUUUU\Z\UUUUUUUUUUI
IUUUUUUUUUUUU/Z/UUUUUUUUUUU\Z\UUUUUUUUUI
IUUUU/TUT\UU/Z/UUUUUUUUUUUUU\Z\UU/TUT\UI
IIIIITT~TIIIIIUUUUUUUKUUUUUUU\ZIIIT~TIII
IUUUU\TUT/UU\Z\UUUUUUUUUUUUUU/IUU\TUT/UI
IUUUUUUUUUUUU\Z\UUUUUUUUUUUUUIIUUUUUUUUI
IUWWUUUUUUUUUU\Z\UUUUUUUUUUUUI/UUUUUUUUI
IUWWUUUUUUUUUUU\Z\UUqQqUU/IT~TUUUUUUUUUI
IUUUbUUUUUUUUUUU\IIIIIIIII/UUUUUUUUUUUUI
IUUUUUUUUUUUUUUUUUUUUUUUUIUUUUUUUUUUUUUI
IUUUUUUUUUUUUUUUUUUUUUUUUIUUUUUUUUUUUUUI
IUUUUbUUUUUUUbUUUUbUUUUUUIUUUUUWWUUUUUUI
IUUUUUUUUUUUUUUUUUUUUUUUUIIIIIIWWUUUUUUI
IIIIIIIIIIIIIIWWWIUUUUUUUIUUUUUUUUUUUUUI
IUUUUUUUUUUUUUWWWUUUUUUUUIUUUUUUUUUUUUUI
IUAAAAAUUUUUUUUUUUUUUUUUUIUUUUUUUUUUUUUI
IUAF-_UUUUUUUUeUUUUUUUUUUIUUUUUUUUUUUUUI
IUAFFFAUUUUUUUUUUUUUUUUUUIUUUUWWIIIIIIII
IIIFIIIIIIIIIIUUUU/TUT\UUIUUUUWWUUUUUUUI
111#111111111IIIIIIT~TIIIIUUUUUUUUUUUUUI
1GGGGGGGGGGGGIPcUU\TUT/U/I\UUUUUUWUWUUUI
1GGGGGGGGGGGGIUUUUUUUUUUTTTUUUUUUUUUUUUI
1GGGGGGGGGGGGIUUCUU4UUUUU~UUUUUUUWUWUUUI
1GGGGGGGGGGGGIUUUUUUUUUUTTTUUUUUUUUUUUUI
1GGGGGGGGGGGGIUUUUUUUUUU\I/UUUUUUUUUUUUI
1XXXX111111111IIpIIhIIIIIIIIIIIIIIIIIIII