IIIIIIIIIIIIIIIIIIIIIIIIIIIIIIIIIIIIIIIIIIIIIIIIIIIIIIIIIIIIIIII
I..............................................................I
I..............................................................I
I..............................................................I
I..............................................................I
I..............................................................I
I..............................................................I
I..............................................................I
I..............................................................I
I..............................................................I
I..............................................................I
I..............................................................I
I..............................................................I
I..............................................................I
I..............................................................I
I..............................................................I
I..............................................................I
I..............................................................I
I..............................................................I
I..............................................................I
II.............................................I...............I
II.............................................I...............I
II.............................................I...............I
II.............................................I...............I
II.............................................I...............I
I..............................................................I
I{{{{{{{{{{{{{{{{{{{{{{{{{{{{{{{{{{{{{{{{{{{{{{{{{{{{{{{{{{{{{{{
I..............................................................I
I......IIIIIIIIIIIIIIIIII......................................I
II.....I/..............I................I......................I
II.....I...............I.........IIIIIIII......................I
II.....I.../IIIIIIIIIIII.IIIIII..I.............................I
I......I...I...I/.\......IFFFFI................................I
I......I...I....I..\.....IFFFFI......V.........................I
IIIIIIII...I....I...I....IFFFFI................................I
I.....IIIIIIIIIIIIIIIIIIIIFFFFIIIIIIIIIIIIIIIII................I
I.....I........IIIIIIIIII/....\IIIIIII........I................I
I.....I........I....................II........I................I
I.....I........I....................II........I................I
I.....I........I....................II........I.....IXXXI......I
I.....I........I....................II........III...I000I.._...I
I.....I........I....................II........I\I...ILLLI......I
II....I........I....................II........I.XX..ILnLI......I
I/....I........I....................II........I.IX..ILLLI......I
X.....I........I....................\IIIIIIIIII/IIII/LLL\IIIIIII
X.....I........I.....................FFFFFFFFFFFX3LLLLLLLLLLLL1X
X.....I........I.....................FFFFFFFFFFFX3FFFFFFFFFFFF1X
X.....I........I.....................FFFFFFFFFFFX3FwFFFFFFFFeF1X
X.....I........I.....................FFFFFFFFFFFX3LLLLLLLLLLLL1X
I\....I........I..................../IIIIIIIIII\IIII\LLL/IIIIIII
II....I........I....................II........II....ILLLI......I
II....I........I....................II........II....ILsLI......I
II....I........I....................II........II....ILLLI......I
II....I........I....................II........II...LI222I......I
II....I........I....................II........II....IXXXI......I
II\...I........I....................II........II...............I
IIIIIIIIIIIIIIIIIIIIIIIII\..../IIIIIIIIIIIIIIIIIIIIIIIIIIIIIIIII
I........................IFFFFI.........XXXXXXXXX..............I
I....=...................IFFFFI..........................#.....I
IIIIIIIIIIIIIIIIIIIIIIIIIIFFFFI....ESZ{}............()....R.T..I
I.................FFFFFFFFFFFFI................................I
I.................FFFFFFFFFFFFI.........................C......I
I.................FFFFFFFFFFFFI................................I
IIIIIIIIIIIIIIIIIIIIIIIIIIIIIIIIIIIIIIIIIIIIIIIIIIIIIIIIIIIIIIII
