IIIIIIIIIIIIIIIIIIIIIIIIIIIIIIIIIIIIIIIIIIIIIIIIIIIIIIIIIIIIIIII
I..............................................................I
I..............................................................I
I..............................................................I
I..............................................................I
I..............................................................I
I..............................................................I
I..............................................................I
I..............................................................I
I..............................................................I
I..............................................................I
I..............................................................I
I..............................................................I
I..............................................................I
I..............................................................I
I..............................................................I
I..............................................................I
I..............................................................I
I..............................................................I
I..............................................................I
II.............................................I...............I
II.............................................I...............I
II.............................................I...............I
II.............................................I...............I
II.............................................I...............I
I..............................................................I
I{{{{{{{{{{{{{{{{{{{{{{{{{{{{{{{{{{{{{{{{{{{{{{{{{{{{{{{{{{{{{{{
I..............................................................I
I......IIIIIIIIIIIIIIIIII......................................I
II.....I/..............I................I......................I
II.....I...............I.........IIIIIIII......................I
II.....I.../IIIIIIIIIIII.IIIIII..I.............................I
I......I...I...I/.\......IFFFFI................................I
I......I...I....I..\.....IFFFFI......V.........................I
IIIIIIII...I....I...I....IFFFFI................................I
I.....IIIIIIIIIIIIIIIIIIIIFFFFIIIIIIIIIIIIIIIII................I
I.....I........IIIIIIIIII/....\IIIIIII........I................I
I.....I........I....................II........I................I
I.....I........I....................II........I................I
I.....I........I....................II........I.....IXXXI......I
I.....I........I....................II........III...IFFFI.._...I
I.....I........I....................II........I\I...IFFFI......I
II....I........I....................II........I.XX..IFFFI......I
I/....I........I....................II........I.IX..IFFFI......I
X.....I........I....................\IIIIIIIIII/I\II/FFF\IIIII/I
X.....I........I.....................FFFFFFFFFFFIFFFFFFFFFFFFFFI
X.....I........I.....................FFFFFFFFFFFXFFFFFFFFFFFFFFX
X.....I........I.....................FFFFFFFFFFFXFFFFFFFFFF4FFFX
X.....I........I.....................FFFFFFFFFFFIFFFFFFFFFFFFFFI
I\....I........I..................../IIIIIIIIII\I/II\FFF/IIIII\I
II....I........I....................II........II....IFFFI......I
II....I........I....................II........II....IFFFI......I
II....I........I....................II........II....IFFFI......I
II....I........I....................II........II...LIFFFI......I
II....I........I....................II........II....IXXXI......I
II\...I........I....................II........II...............I
IIIIIIIIIIIIIIIIIIIIIIIII\..../IIIIIIIIIIIIIIIIIIIIIIIIIIIIIIIII
I........................IFFFFI.........XXXXXXXXX..............I
I....=...................IFFFFI..........................#.....I
IIIIIIIIIIIIIIIIIIIIIIIIIIFFFFI....ESZ{}............()....R.T..I
I.................FFFFFFFFFFFFI................................I
I.................FFFFFFFFFFFFI.........................C......I
I.................FFFFFFFFFFFFI................................I
IIIIIIIIIIIIIIIIIIIIIIIIIIIIIIIIIIIIIIIIIIIIIIIIIIIIIIIIIIIIIIII
