00000000
00010010
01010100
00101000
01000100
00001000
01111100
00010003