00010111
01000010
00100003
01000010
00100010
01000010
00111100
00021000