,,,,,,,,,,,,,,,,,,,,,,,,,,,,,,,,
,,,,,,,,,,,,,,,,,,,,,,,,,,,,,,,,
,,IIIIIIIIIIIII,,,,,,,,,,,,,,,,,
,,IFFFFF......I,,,,,,,,,,,,,,,,,
,,IFFFFF......I,,,,,,,,,,,,,,,,,
,,I...........I,,,,,,,,,,,,,,,,,
,,I...........I,,,,,,,,,,,,,,,,,
,,I...........I,,,,,,,,,,,,,,,,,
,,I...........I,,,,,,,,,,,,,,,,,
,,I...........I,,,,,,,,,,,,,,,,,
,,I....n......I,,,,,,,,,,,,,,,,,
,,I...wse.....I,,,,,,,,,,,,,,,,,
,,I...........I,,,,,,,,,,,,,,,,,
,,IIIII222IIIII,,,,,,,,,,,,,,,,,
,,,,,,IXXXI,,,,,,,,,,,,,,,,,,,,,
,,,,,,,,,,,,,,,,,,,,,,,,,,,,,,,,
,,,,,,,,,,,,,,,,,,,,,,,,,,,,,,,,
,,,,,,,,,,,,,,,,,,,,,,,,,,,,,,,,
,,,,,,,,,,,,,,,,,,,,,,,,,,,,,,,,
,,,,,,,,,,,,,,,,,,,,,,,,,,,,,,,,
,,,,,,,,,,,,,,,,,,,,,,,,,,,,,,,,
,,,,,,,,,,,,,,,,,,,,,,,,,,,,,,,,
,,,,,,,,,,,,,,,,,,,,,,,,,,,,,,,,
,,,,,,,,,,,,,,,,,,,,,,,,,,,,,,,,
,,,,,,,,,,,,,,,,,,,,,,,,,,,,,,,,
,,,,,,,,,,,,,,,,,,,,,,,,,,,,,,,,
,,,,,,,,,,,,,,,,,,,,,,,,,,,,,,,,
,,,,,,,,,,,,,,,,,,,,,,,,,,,,,,,,
,,,,,,,,,,,,,,,,,,,,,,,,,,,,,,,,
,,,,,,,,,,,,,,,,,,,,,,,,,,,,,,,,
,,,,,,,,,,,,,,,,,,,,,,,,,,,,,,,,
,,,,,,,,,,,,,,,,,,,,,,,,,,,,,,,,
