,IIIIIIIIIIIIIIIIIIIIII,,,,,,,,,
,IFFFFFFFFFFFFFFFFFFFFI,,,,,,,,,
,IFFFFFFFFFFFFFFFFFFFFI,,,,,,,,,
,IHHHHHHHHHHHHHFFFFFFFI,,,,,,,,,
,I............HFFFFFFFI,,,,,,,,,
,I............HFFFFFFFI,,,,,,,,,
,I.....nse....HFFFFFFFI,,,,,,,,,
I/............HFFFFFFFI,,,,,,,,,
X3............HFFFFFFFI,,,,,,,,,
X3.w..........IIFFFFFFI,,,,,,,,,
X3............FIFFFFFFI,,,,,,,,,
X3............FIFFFFFFI,,,,,,,,,
I\............IIFFFFFFI,,,,,,,,,
,IIIIIIIIIIIIIIIIIIIIII,,,,,,,,,
,,,,,,,,,,,,,,,,,,,,,,,,,,,,,,,,
,,,,,,,,,,,,,,,,,,,,,,,,,,,,,,,,
,,,,,,,,,,,,,,,,,,,,,,,,,,,,,,,,
,,,,,,,,,,,,,,,,,,,,,,,,,,,,,,,,
,,,,,,,,,,,,,,,,,,,,,,,,,,,,,,,,
,,,,,,,,,,,,,,,,,,,,,,,,,,,,,,,,
,,,,,,,,,,,,,,,,,,,,,,,,,,,,,,,,
,,,,,,,,,,,,,,,,,,,,,,,,,,,,,,,,
,,,,,,,,,,,,,,,,,,,,,,,,,,,,,,,,
,,,,,,,,,,,,,,,,,,,,,,,,,,,,,,,,
,,,,,,,,,,,,,,,,,,,,,,,,,,,,,,,,
,,,,,,,,,,,,,,,,,,,,,,,,,,,,,,,,
,,,,,,,,,,,,,,,,,,,,,,,,,,,,,,,,
,,,,,,,,,,,,,,,,,,,,,,,,,,,,,,,,
,,,,,,,,,,,,,,,,,,,,,,,,,,,,,,,,
,,,,,,,,,,,,,,,,,,,,,,,,,,,,,,,,
,,,,,,,,,,,,,,,,,,,,,,,,,,,,,,,,
,,,,,,,,,,,,,,,,,,,,,,,,,,,,,,,,
