,IIIIIIIIIIIIIIIIIIIIIIIIIIIIII,
,IFFFFFFFFFFFFFFFFFFFFFFFFFFFFI,
,IFFFFFFFFFFFFFFFFFFFFFFFFFFFFI,
,IFFFFFFFFFFFFFFFFFFFFFFFFFFFFI,
,IPPPPPPIIIIIIIFFFFIIIIIIIPPPPI,
,I......I....\IPPPPI/....I....I,
,I......I...............LI....I,
,I......I...............LI....I,
,I......I...............LI....I,
,I......I...............LI....I,
,I......I................I....\I
,I......IMMMMMMMMMMMMMMMMI....1B
,I......ISSSSSSSSSSSSSSSSI\.e.1B
,/PPPPPPIXXXSSSSSSSSSSSSSIIIIIII
B3FFFFFFIXXXSSSSSS}SSS}SSI,,,,,,
B3FFwFFFIXXXSSSSSSS}SSS}SI,,,,,,
B3FFFFFFISSSI###ISSSISSSII,,,,,,
,\FFFFFFISTSIIIIISTSISTSII,,,,,,
,IIIIIIIISRSIIIIISRSISRSII,,,,,,
,,,,,,,,ISSSIIIIISSSISSSII,,,,,,
,,,,,,,,IIIIIIIIIIIIIIIIII,,,,,,
,,,,,,,,,,,,,,,,,,,,,,,,,,,,,,,,
,,,,,,,,,,,,,,,,,,,,,,,,,,,,,,,,
,,,,,,,,,,,,,,,,,,,,,,,,,,,,,,,,
,,,,,,,,,,,,,,,,,,,,,,,,,,,,,,,,
,,,,,,,,,,,,,,,,,,,,,,,,,,,,,,,,
,,,,,,,,,,,,,,,,,,,,,,,,,,,,,,,,
,,,,,,,,,,,,,,,,,,,,,,,,,,,,,,,,
,,,,,,,,,,,,,,,,,,,,,,,,,,,,,,,,
,,,,,,,,,,,,,,,,,,,,,,,,,,,,,,,,
,,,,,,,,,,,,,,,,,,,,,,,,,,,,,,,,
,,,,,,,,,,,,,,,,,,,,,,,,,,,,,,,,
