IIIIIIIIIIIIIIIIII,,,,,,,,,,,,,,
I................I,,,,,,,,,,,,,,
I........[.......I,,,,,,,,,,,,,,
I.......[........I,,,,,,,,,,,,,,
I......[.........I,,,,,,,,,,,,,,
I.....[..}.......I,,,,,,,,,,,,,,
I....[...L.......I,,,,,,,,,,,,,,
I....]...{.......\IIII,,,,,,,,,,
I.....]..........1FFFX,,,,,,,,,,
I......].........1FFFX,,,,,,,,,,
I.......]......e.1FFFX,,,,,,,,,,
I........].......1FFFX,,,,,,,,,,
I...nsw........../IIII,,,,,,,,,,
I................I,,,,,,,,,,,,,,
IIIIIIIIIIIIIIIIII,,,,,,,,,,,,,,
,,,,,,,,,,,,,,,,,,,,,,,,,,,,,,,,
,,,,,,,,,,,,,,,,,,,,,,,,,,,,,,,,
,,,,,,,,,,,,,,,,,,,,,,,,,,,,,,,,
,,,,,,,,,,,,,,,,,,,,,,,,,,,,,,,,
,,,,,,,,,,,,,,,,,,,,,,,,,,,,,,,,
,,,,,,,,,,,,,,,,,,,,,,,,,,,,,,,,
,,,,,,,,,,,,,,,,,,,,,,,,,,,,,,,,
,,,,,,,,,,,,,,,,,,,,,,,,,,,,,,,,
,,,,,,,,,,,,,,,,,,,,,,,,,,,,,,,,
,,,,,,,,,,,,,,,,,,,,,,,,,,,,,,,,
,,,,,,,,,,,,,,,,,,,,,,,,,,,,,,,,
,,,,,,,,,,,,,,,,,,,,,,,,,,,,,,,,
,,,,,,,,,,,,,,,,,,,,,,,,,,,,,,,,
,,,,,,,,,,,,,,,,,,,,,,,,,,,,,,,,
,,,,,,,,,,,,,,,,,,,,,,,,,,,,,,,,
,,,,,,,,,,,,,,,,,,,,,,,,,,,,,,,,
,,,,,,,,,,,,,,,,,,,,,,,,,,,,,,,,
